-1 -1 -1 -1 -1 -1 -1 -1 -1 -1 -1 -1 -1
-1 00 01 02 03 04 -1 05 06 -1 07 08 -1
-1 09 -1 -1 10 -1 -1 -1 11 -1 -1 12 -1
-1 -1 -1 13 14 15 16 -1 17 18 -1 19 -1
-1 20 21 22 -1 -1 23 -1 -1 24 -1 25 -1
-1 -1 -1 26 -1 27 28 29 -1 30 31 32 -1
-1 33 -1 34 35 36 37 38 39 40 -1 41 -1
-1 42 -1 43 -1 44 45 46 -1 47 -1 48 -1
-1 49 50 51 -1 -1 52 -1 -1 53 -1 -1 -1
-1 -1 -1 54 55 56 57 58 59 60 -1 61 -1
-1 62 -1 -1 63 -1 -1 -1 64 -1 -1 65 -1
-1 66 67 68 69 -1 70 71 72 73 74 75 -1
-1 -1 -1 -1 -1 -1 -1 -1 -1 -1 -1 -1 -1